[
  {
    "id": 20,
    "slug": "level-20",
    "title": "Final Scaffold Yard",
    "width": 34,
    "height": 17,
    "difficulty": 20,
    "grid": [
      "##################################",
      "#................................#",
      "#................................#",
      "#................................#",
      "#................................#",
      "#................................#",
      "#................................#",
      "#.............................G..#",
      "#...........................######",
      "#................................#",
      "#................................#",
      "#................................#",
      "#....B.B.B..........B.B.B.B......#",
      "#...#######.......##########.....#",
      "#................................#",
      "#PB.B.B.B.B.B..B.B...............#",
      "##################################"
    ]
  },
  {
    "id": 21,
    "slug": "level-21",
    "title": "Recover the First Step",
    "width": 14,
    "height": 11,
    "difficulty": 21,
    "grid": [
      "##############",
      "#............#",
      "#............#",
      "#............#",
      "#............#",
      "#.........G..#",
      "#....B....####",
      "#...###......#",
      "#PBB.........#",
      "##############",
      "##############"
    ]
  },
  {
    "id": 22,
    "slug": "level-22",
    "title": "The Pit Toll",
    "width": 16,
    "height": 12,
    "difficulty": 22,
    "grid": [
      "################",
      "#..............#",
      "#..............#",
      "#..............#",
      "#..............#",
      "#............G.#",
      "#............###",
      "#..............#",
      "#PBBBB.........#",
      "######....######",
      "#..............#",
      "################"
    ]
  },
  {
    "id": 23,
    "slug": "level-23",
    "title": "The Higher Base",
    "width": 17,
    "height": 12,
    "difficulty": 23,
    "grid": [
      "#################",
      "#...............#",
      "#...............#",
      "#...............#",
      "#............G..#",
      "#............####",
      "#...............#",
      "#.......B.B.....#",
      "#......######...#",
      "#PBB............#",
      "#################",
      "#################"
    ]
  },
  {
    "id": 24,
    "slug": "level-24",
    "title": "Shelf Before Scaffold",
    "width": 17,
    "height": 13,
    "difficulty": 24,
    "grid": [
      "#################",
      "#...............#",
      "#...............#",
      "#...............#",
      "#...............#",
      "#.............G.#",
      "#..........B..###",
      "#.........###...#",
      "#.......B.......#",
      "#.....########..#",
      "#PBB............#",
      "#################",
      "#################"
    ]
  },
  {
    "id": 25,
    "slug": "level-25",
    "title": "Quarry Toll",
    "width": 17,
    "height": 12,
    "difficulty": 25,
    "grid": [
      "#################",
      "#...............#",
      "#...............#",
      "#...............#",
      "#...............#",
      "#.............G.#",
      "#....BB.......###",
      "#...###.........#",
      "#PBBB...........#",
      "#######....######",
      "#...............#",
      "#################"
    ]
  },
  {
    "id": 26,
    "slug": "level-26",
    "title": "Bring the Exit Block",
    "width": 20,
    "height": 14,
    "difficulty": 26,
    "grid": [
      "####################",
      "#..................#",
      "#..................#",
      "#..................#",
      "#..................#",
      "#..................#",
      "#..................#",
      "#...............G..#",
      "#...............####",
      "#..................#",
      "#PBBBB.............#",
      "########....########",
      "########....########",
      "####################"
    ]
  },
  {
    "id": 27,
    "slug": "level-27",
    "title": "Harvest Before Climb",
    "width": 22,
    "height": 15,
    "difficulty": 27,
    "grid": [
      "######################",
      "#....................#",
      "#....................#",
      "#....................#",
      "#....................#",
      "#....................#",
      "#....................#",
      "#................G...#",
      "#...............######",
      "#....................#",
      "#.....BB.......B.....#",
      "#....####....#########",
      "#PB..................#",
      "######################",
      "######################"
    ]
  },
  {
    "id": 28,
    "slug": "level-28",
    "title": "Carry Into the Basin",
    "width": 24,
    "height": 15,
    "difficulty": 28,
    "grid": [
      "########################",
      "#......................#",
      "#......................#",
      "#......................#",
      "#......................#",
      "#......................#",
      "#......................#",
      "#..................G...#",
      "#.................######",
      "#......................#",
      "#PBBB...........BB.....#",
      "########......##########",
      "########......##########",
      "########################",
      "########################"
    ]
  },
  {
    "id": 29,
    "slug": "level-29",
    "title": "Shelf Before Crossing",
    "width": 24,
    "height": 14,
    "difficulty": 29,
    "grid": [
      "########################",
      "#......................#",
      "#......................#",
      "#......................#",
      "#......................#",
      "#......................#",
      "#......................#",
      "#..................G...#",
      "#....BB...........######",
      "#...#####..............#",
      "#PBB...........B.......#",
      "#########....###########",
      "#########....###########",
      "########################"
    ]
  },
  {
    "id": 30,
    "slug": "level-30",
    "title": "Two Quarries, One Crossing",
    "width": 26,
    "height": 14,
    "difficulty": 30,
    "grid": [
      "##########################",
      "#........................#",
      "#........................#",
      "#........................#",
      "#........................#",
      "#........................#",
      "#........................#",
      "#...................G....#",
      "#....BB.......BB....######",
      "#...#####....#####.......#",
      "#PBB.....................#",
      "#########....#############",
      "#########....#############",
      "##########################"
    ]
  }
]