[
  {
    "id": 41,
    "slug": "level-41",
    "title": "Borrowed High Ledge",
    "width": 30,
    "height": 18,
    "difficulty": 41,
    "grid": [
      "##############################",
      "#............................#",
      "#............................#",
      "#............................#",
      "#............................#",
      "#............................#",
      "#............................#",
      "#............................#",
      "#............................#",
      "#............................#",
      "#.........................G..#",
      "#.........................####",
      "#............................#",
      "#............................#",
      "#......BBB...................#",
      "#....######.....##########...#",
      "#PBBB..........#.............#",
      "##############################"
    ]
  },
  {
    "id": 42,
    "slug": "level-42",
    "title": "Missing Floor Debt",
    "width": 34,
    "height": 18,
    "difficulty": 42,
    "grid": [
      "##################################",
      "#................................#",
      "#................................#",
      "#................................#",
      "#................................#",
      "#................................#",
      "#................................#",
      "#................................#",
      "#................................#",
      "#................................#",
      "#.............................G..#",
      "#.............................####",
      "#................................#",
      "#................................#",
      "#.........BBB....................#",
      "#.......########.#############...#",
      "#PBBBB.#........#................#",
      "##################################"
    ]
  },
  {
    "id": 43,
    "slug": "level-43",
    "title": "Two Missing Teeth",
    "width": 36,
    "height": 18,
    "difficulty": 43,
    "grid": [
      "####################################",
      "#..................................#",
      "#..................................#",
      "#..................................#",
      "#..................................#",
      "#..................................#",
      "#..................................#",
      "#..................................#",
      "#..................................#",
      "#..................................#",
      "#...............................G..#",
      "#...............................####",
      "#..................................#",
      "#..................................#",
      "#........BBB.......................#",
      "#.......#####.#####.############...#",
      "#PBBBBB#.....#.....#...............#",
      "####################################"
    ]
  },
  {
    "id": 44,
    "slug": "level-44",
    "title": "Two-Deep Cranny",
    "width": 34,
    "height": 19,
    "difficulty": 44,
    "grid": [
      "##################################",
      "#................................#",
      "#................................#",
      "#................................#",
      "#................................#",
      "#................................#",
      "#................................#",
      "#................................#",
      "#................................#",
      "#.............................G..#",
      "#.............................####",
      "#................................#",
      "#................................#",
      "#..........BBB...................#",
      "#.........#######.############...#",
      "#........#.......................#",
      "#.......#........#...............#",
      "#PBBBBB#.........................#",
      "##################################"
    ]
  },
  {
    "id": 45,
    "slug": "level-45",
    "title": "Three Quarries Exact",
    "width": 38,
    "height": 20,
    "difficulty": 45,
    "grid": [
      "######################################",
      "#....................................#",
      "#....................................#",
      "#....................................#",
      "#....................................#",
      "#....................................#",
      "#....................................#",
      "#....................................#",
      "#....................................#",
      "#....................................#",
      "#.................................G..#",
      "#.................................####",
      "#....######.............#####........#",
      "#.................BBB................#",
      "#................#######.............#",
      "#........BBB....#....................#",
      "#.......########.........#########...#",
      "#......#................#............#",
      "#PBBBB#................#.............#",
      "######################################"
    ]
  },
  {
    "id": 46,
    "slug": "level-46",
    "title": "Double-Fill Causeway",
    "width": 42,
    "height": 20,
    "difficulty": 46,
    "grid": [
      "##########################################",
      "#........................................#",
      "#........................................#",
      "#........................................#",
      "#........................................#",
      "#........................................#",
      "#........................................#",
      "#........................................#",
      "#........................................#",
      "#........................................#",
      "#..................................G.....#",
      "#..................................#######",
      "#........................................#",
      "#........................................#",
      "#..####....................#####.........#",
      "#..........BBBB..BBB.....................#",
      "#........#############.############......#",
      "#.......#................................#",
      "#PBBBBB#..............#..................#",
      "##########################################"
    ]
  },
  {
    "id": 47,
    "slug": "level-47",
    "title": "Top-Down Quarry",
    "width": 40,
    "height": 20,
    "difficulty": 47,
    "grid": [
      "########################################",
      "#......................................#",
      "#......................................#",
      "#......................................#",
      "#......................................#",
      "#......................................#",
      "#......................................#",
      "#......................................#",
      "#......................................#",
      "#......................................#",
      "#..................................G...#",
      "#..................................#####",
      "#......................................#",
      "#...........B..........................#",
      "#..........#B..........................#",
      "#...........B#...BBB...................#",
      "#.......#######.#####....##########....#",
      "#......#................#..............#",
      "#PBBBB#................#...............#",
      "########################################"
    ]
  },
  {
    "id": 48,
    "slug": "level-48",
    "title": "Broken High Causeway",
    "width": 44,
    "height": 21,
    "difficulty": 48,
    "grid": [
      "############################################",
      "#..........................................#",
      "#..........................................#",
      "#..........................................#",
      "#..........................................#",
      "#..........................................#",
      "#..........................................#",
      "#..........................................#",
      "#..........................................#",
      "#..........................................#",
      "#..........................................#",
      "#....................................G.....#",
      "#....................................#######",
      "#..........................................#",
      "#....########..............#######.........#",
      "#..........................................#",
      "#.........BBBB......BBB....................#",
      "#........#########.#####.############......#",
      "#.......#.........#.....#..................#",
      "#PBBBBB#...................................#",
      "############################################"
    ]
  },
  {
    "id": 49,
    "slug": "level-49",
    "title": "Keyhole Fill",
    "width": 44,
    "height": 22,
    "difficulty": 49,
    "grid": [
      "############################################",
      "#..........................................#",
      "#..........................................#",
      "#..........................................#",
      "#..........................................#",
      "#..........................................#",
      "#..........................................#",
      "#..........................................#",
      "#..........................................#",
      "#..........................................#",
      "#..........................................#",
      "#...................................G......#",
      "#...................................########",
      "#..........................................#",
      "#...#####................######............#",
      "#..........................................#",
      "#...........BBBB.BBB.......................#",
      "#..........#########.###############.......#",
      "#.........#................................#",
      "#........#.................................#",
      "#PBBBBBB#...........#......................#",
      "############################################"
    ]
  },
  {
    "id": 50,
    "slug": "level-50",
    "title": "Cathedral Scaffold",
    "width": 50,
    "height": 23,
    "difficulty": 50,
    "grid": [
      "##################################################",
      "#................................................#",
      "#................................................#",
      "#................................................#",
      "#................................................#",
      "#................................................#",
      "#................................................#",
      "#................................................#",
      "#................................................#",
      "#................................................#",
      "#................................................#",
      "#..............................................G.#",
      "#..............................................###",
      "#....##########.....########......#########......#",
      "#................................................#",
      "#....................BBB.........................#",
      "#..................#########.....................#",
      "#...........BBBB..#............BB................#",
      "#..........#######............#################..#",
      "#.........#..................#...................#",
      "#........#..................#....................#",
      "#PBBBBBB#..................#.....................#",
      "##################################################"
    ]
  }
]