[
  {
    "id": 31,
    "slug": "level-31",
    "title": "Left First Debt",
    "width": 28,
    "height": 20,
    "difficulty": 31,
    "grid": [
      "############################",
      "#..........................#",
      "#..........................#",
      "#..........................#",
      "#..........................#",
      "#..........................#",
      "#..........................#",
      "#..........................#",
      "#..........................#",
      "#........................G.#",
      "#........................###",
      "#..........................#",
      "#....BB....................#",
      "#...#####.......#########..#",
      "#PBBBB.....................#",
      "##########...###############",
      "#..........................#",
      "#..........................#",
      "#.........###..............#",
      "############################"
    ]
  },
  {
    "id": 32,
    "slug": "level-32",
    "title": "Enter With the Exit",
    "width": 30,
    "height": 18,
    "difficulty": 32,
    "grid": [
      "##############################",
      "#............................#",
      "#............................#",
      "#............................#",
      "#............................#",
      "#............................#",
      "#............................#",
      "#............................#",
      "#............................#",
      "#.......................G....#",
      "#.......................######",
      "#....BB......................#",
      "#...#####..........B.........#",
      "#.................####.......#",
      "#............................#",
      "#PBBBB.......................#",
      "###########.....##############",
      "##############################"
    ]
  },
  {
    "id": 33,
    "slug": "level-33",
    "title": "Tunnel Toll",
    "width": 31,
    "height": 18,
    "difficulty": 33,
    "grid": [
      "###############################",
      "#.............................#",
      "#.............................#",
      "#.............................#",
      "#.............................#",
      "#.............................#",
      "#.............................#",
      "#.............................#",
      "#.............................#",
      "#........................G....#",
      "#........................######",
      "#.............................#",
      "#.....BB......................#",
      "#....#########........B.......#",
      "#................########.....#",
      "#PBBBB........................#",
      "############....###############",
      "###############################"
    ]
  },
  {
    "id": 34,
    "slug": "level-34",
    "title": "The Sacrifice Gap",
    "width": 32,
    "height": 18,
    "difficulty": 34,
    "grid": [
      "################################",
      "#..............................#",
      "#..............................#",
      "#..............................#",
      "#..............................#",
      "#..............................#",
      "#..............................#",
      "#..............................#",
      "#..............................#",
      "#.........................G....#",
      "#.........................######",
      "#....BB........................#",
      "#...######.....................#",
      "#...................BB.........#",
      "#........####.....#####........#",
      "#PBBBB.........................#",
      "#############.....##############",
      "################################"
    ]
  },
  {
    "id": 35,
    "slug": "level-35",
    "title": "Wrong Quarry First",
    "width": 33,
    "height": 19,
    "difficulty": 35,
    "grid": [
      "#################################",
      "#...............................#",
      "#...............................#",
      "#...............................#",
      "#...............................#",
      "#...............................#",
      "#...............................#",
      "#...............................#",
      "#...........................G...#",
      "#...........................#####",
      "#...............................#",
      "#.......................BB......#",
      "#....BB................#####....#",
      "#...######.......B..............#",
      "#..............######...........#",
      "#...............................#",
      "#PBBBB..........................#",
      "############....########....#####",
      "#################################"
    ]
  },
  {
    "id": 36,
    "slug": "level-36",
    "title": "Bury Nothing",
    "width": 32,
    "height": 18,
    "difficulty": 36,
    "grid": [
      "################################",
      "#..............................#",
      "#..............................#",
      "#..............................#",
      "#..............................#",
      "#..............................#",
      "#..............................#",
      "#..............................#",
      "#.........................G....#",
      "#.........................######",
      "#..............................#",
      "#....B.........................#",
      "#....BB..................B.....#",
      "#...#####......B........####...#",
      "#...........#######............#",
      "#PBBB..........................#",
      "####################....########",
      "################################"
    ]
  },
  {
    "id": 37,
    "slug": "level-37",
    "title": "Switchback Debt",
    "width": 34,
    "height": 20,
    "difficulty": 37,
    "grid": [
      "##################################",
      "#................................#",
      "#................................#",
      "#................................#",
      "#................................#",
      "#................................#",
      "#................................#",
      "#................................#",
      "#............................G...#",
      "#............................#####",
      "#..................B.............#",
      "#................######..........#",
      "#....BBB.........................#",
      "#...#######................B.....#",
      "#........................######..#",
      "#.............BB.................#",
      "#...........#######..............#",
      "#PBBBB...........................#",
      "###########....##########....#####",
      "##################################"
    ]
  },
  {
    "id": 38,
    "slug": "level-38",
    "title": "Two Commitment Basins",
    "width": 35,
    "height": 20,
    "difficulty": 38,
    "grid": [
      "###################################",
      "#.................................#",
      "#.................................#",
      "#.................................#",
      "#.................................#",
      "#.................................#",
      "#.................................#",
      "#.................................#",
      "#.............................G...#",
      "#.............................#####",
      "#.................................#",
      "#.................................#",
      "#.........................BB......#",
      "#...BB..................######....#",
      "#..#####.......BB.................#",
      "#............#######..............#",
      "#.................................#",
      "#PBBBB............................#",
      "########....########....###########",
      "###################################"
    ]
  },
  {
    "id": 39,
    "slug": "level-39",
    "title": "Almost Enough",
    "width": 36,
    "height": 20,
    "difficulty": 39,
    "grid": [
      "####################################",
      "#..................................#",
      "#..................................#",
      "#..................................#",
      "#..................................#",
      "#..................................#",
      "#..................................#",
      "#..................................#",
      "#..............................G...#",
      "#..............................#####",
      "#..................................#",
      "#.................######...........#",
      "#....BB...................BB.......#",
      "#...######...............######....#",
      "#.............BB...................#",
      "#...........##########.............#",
      "#..................................#",
      "#PBBBB.............................#",
      "#############.....##################",
      "####################################"
    ]
  },
  {
    "id": 40,
    "slug": "level-40",
    "title": "Grand Commitment Yard",
    "width": 38,
    "height": 22,
    "difficulty": 40,
    "grid": [
      "######################################",
      "#....................................#",
      "#....................................#",
      "#....................................#",
      "#....................................#",
      "#....................................#",
      "#....................................#",
      "#....................................#",
      "#................................G...#",
      "#................................#####",
      "#.............######.................#",
      "#.....BBB............................#",
      "#....########.......BB...............#",
      "#.................########...........#",
      "#.............................BB.....#",
      "#....BB.....................######...#",
      "#...######......BB...................#",
      "#.............########...............#",
      "#....................................#",
      "#PBBBBB..............................#",
      "##########....###########....#########",
      "######################################"
    ]
  }
]